0101100001010
0000010001000
0001000100100
0001000100010
0000101000100

